#############
#           #
#           #
#     @     #
#############
